BB..........................B
............................B
............................B
............................B
............................B
............................B
............................B
............................B
.............BBBBBB.........B
.........B..................B
P..B..B..B..................B
BBBBBBBBBBBBBBBBBBBBBBBBBBBBB
............................B
.........B..................B
BBBBBBBBBBBBBBBBBBBBBBBBBBBBB